NO ./textures/wall1.xpm
SO ./textures/wall2.xpm
EA ./textures/wall3.xpm
WE ./textures/titan.xpm

F 50,50,50
C 10,10,10

111111111111111111111111
1X0000000R00000T00000001
100010000000000000000001
1000011111111100000R0001
100000000000000000000001
10000010000X000000000001
100000100000000000000001
100000101110000000000001
100R00100000010000000T01
100000100000010000000001
10000010010X010000000001
100000100100010111111001
100000100000010000000001
100000100000010000000001
100X000000N0001000R00001
100000010000T00000000001
100000010011001000000001
100011111110001000000001
1000100000000000000T0001
100010000000000111000001
100010000000000001000001
10000000R000000111110001
100000000000000000000001
111111111111111111111111