      C 60,10,10
F 30,30,30

NO ./textures/wall1.xpm
SO ./textures/wall2.xpm
EA ./textures/wall3.xpm
WE ./textures/titan.xpm

111111111111
100000000001
100100000001
100S10000001
100000000001
100000000001
111111111111
