C 135,206,235
F 193,154,107
NO ./textures/wall1.xpm
SO ./textures/wall2.xpm
EA ./textures/wall3.xpm
WE ./textures/titan.xpm

  1111111111111111111111
 10000000000000W00000001
100110000000000000000X01
100001111111110000000001
100000D00000000000000T01
100000100000000000000001
100000D00000000000000R01
100000101110000001D10001
100000100000010001010F01
100000100000010001D10001
100000100110010001010001
100000100100010111011001
100000100000010000000001
100000100000010000000001
100000000000000000000001
100000010000000000101001
100000010011001000000001
100011111110001000000001
100010000000000000000001
100010000000000111000001
100010000000000001000001
100010000000000111110001
100000000000000000000001
111111111111111111111111
